level = [
       "----------------------------------",
       "-                                -",
       "-                       --       -",
       "-                                -",
       "-            --                  -",
       "-                                -",
       "--                               -",
       "-                                -",
       "-                   ----     --- -",
       "-                                -",
       "--                               -",
       "-                                -",
       "-                            --- -",
       "-                                -",
       "-                                -",
       "-      ---                       -",
       "-                                -",
       "-   -------         ----         -",
       "-                                -",
       "-                         -      -",
       "-                            --  -",
       "-                                -",
       "-                                -",
       "----------------------------------"]